00010/00010/00010/00000/00000/00000/00000/00000/00000/00000/00000/00000
00000/00000/00010/00000/00000/00000/00000/00000/00000/00000/00000/00000
00010/00010/00010/00000/00000/00000/00000/00000/00000/00000/00000/00000
00000/00000/00000/00000/00000/00000/00000/00000/00000/00000/00000/00000
00000/10020/00000/00000/00000/00000/00000/00000/00000/00000/00000/00000
00010/00010/00010/00010/00010/00010/00010/00010/00010/00010/00010/00010
00000/00000/00000/00000/00000/00000/00000/00000/00000/00000/00000/00000
00000/00000/00000/00000/00000/00000/00000/00000/00000/00000/00000/00000
00000/00000/00000/00000/00000/00000/00000/00000/00000/00000/00000/00000
00000/00000/00000/00000/00000/00000/00000/00000/00000/00000/00000/00000
00000/00000/00000/00000/00000/00000/00000/00000/00000/00000/00000/00000
00000/00000/00000/00000/00000/00000/00000/00000/00000/00000/00000/00000
00000/00000/00000/00000/00000/00000/00000/00000/00000/00000/00000/00000